git config --global user.name  - создания и запись имени пользователя
git config --global user.email - e-mail пользоватиля 
git config --global clor.ui auto - подсветка кода
git config --list - проверка всех изменеий 
ls - показать список файлов в текущей активной дириктори 
cd названия директори  - переход в директрию 
cd .. - на уровень выше
mkdir названия директрои - создания папки 
touch  - создания файла
cp названия файла и куда скапировать - копирования файла
mv названия файла и новое нозвания -переминовать файл
echo "запись" > названия файла(куда хотим вывести текст) - запись в файл
cat названия файла - посмотреть файл
rm файл - удаление файла 
rm -R директория - удаления папки
git init - иницилизация директори 
git add названия файла - регистрация в индексе  изменений 
git commit - создания коммита
git commit -m 'commit message' - запись коммита с собщением
git restore - отмениее изменений 
git commit -am ' название файла '  - автоматическое добовления и коммит
ls -a - скрытае разделы папки
.gitkeep ( файл для показа) 
.gitignore (файл для скрытия)
git log - просмотр логов 
git log --oneline - компактное  отображения логов 
git reset (хеш коммита на какой  мы хотим вернуться) - востановления 
git reflog -подробное описание событий и отброжения запись изменений 
git revert - отмена дестивия совершоное придедушем
git restore - сброс состояния файла на указанное ( на стояние последнего файла)
git dranch - просмотр веток в репозитори (* та ветка на которй  мы находимся)
git branch dev - сознание ветки и нозвание 
git checkout dev -  переключения на ветку 
git branch dev-master masrer - создание  ветки где основа ветка master
git checkout -b dev-test - создание  новой ветки  и переключения на неё 





 
 

